11111111111
1EC10111001
1000P111001
11111111111
