11111111111
1EC1000C001
1000PC00001
11111111111
