111111111111111
11C1C1C1C1C1C11
1E00000000000P1
11C1C1C1C1C1C11
111111111111111
