111111111111111111111111111111
1P0000000000000000011111111111
100000000000000000011111111111
100000000000000000011111111111
100000000000000000011111111111
100000000000000000011111111111
100000000000000000011111110111
100000000000000000011111111111
100000000000000000011111111111
100000000000000000011111111111
100000000000000000011111111111
100000000000000000011111111111
100000000000000000011111111111
10000000C000000000011111111111
100000000000000000E11111111111
111111111111111111111111111111
