1111111111111111111
1CCCCCCCCCCCCCCCCC1
1CCCCCCCCCCCCCCCCC1
1CCCCCCCCCCCCCCCCC1
1CCCCCCCCCCCCCCCCC1
1CCCCCCCPCCCCCCCCC1
1CCCCCCCCCCCCCCCCC1
1CCCCCCCECCCCCCCCC1
1111111111111111111
